Airport = airport
Aquarium = aquarium
Bank = bank
Bus Station = bus_station
Clothing Store = clothing_store
Corner Store = convenience_store
Electronics Store = electronics_store
Fire Station = fire_station
Gas Station = gas_station
Gym = gym
Hair Care = hair_care
Hardware Store = hardware_store
Hindu Temple = hindu_temple
Hospital = hospital
Jewelry Store = jewelry_store
Lawyer = lawyer
Library = library
Liquor Store = liquor_store
Movie Rental = movie_rental
Movie Theater = movie_theater
Museum = museum
Night Club = night_club
Parking = parking
Police = police
Post Office = post_office
Restaurant = restaurant
School = school
Subway Station = subway_station
University = university
Zoo = zoo